map1
10,10
1111111111
1822227221
1722424221
1227277221
1422722221
1222222221
1722477221
1227222241
1224225221
1111111111